Tilemapping Version 1.0
#tileset
img/tilesetoriginal2.png
30 1
tile0: safe
tile1: safe
tile2: danger
tile3: safe
tile4: safe
tile5: safe
tile6: safe
tile7: danger
tile8: safe
tile9: safe
tile10: safe
tile11: safe
tile12: safe
tile13: safe
tile14: safe
tile15: danger
tile16: safe
tile17: safe
tile18: safe
tile19: safe
tile20: danger
tile21: safe
tile22: safe
tile23: safe
tile24: safe
tile25: safe
tile26: safe
tile27: safe
tile28: safe
tile29: safe
#level
60 15
30   30   30   30   30   30   30   30   22   23   23   23   23   24   30   30   29   30   30   30   30   30   30   30   30   30   30   30   30   30   30   30   30   30   30   30   30   30   30   30   30   30   30   30   30   30   30   30   30   30   30   30   30   30   30   30   30   30   30   30   
30   30   22   23   24   30   30   5   7   25   25   25   25   5   6   6   6   6   7   30   30   1   30   30   1   30   30   4   30   30   30   30   30   30   30   30   30   30   30   30   30   30   30   30   30   30   30   30   30   30   30   30   30   30   30   30   30   30   30   30   
30   14   15   15   15   16   30   30   30   30   30   30   30   30   13   8   8   11   30   30   30   30   30   30   30   30   30   3   30   30   30   30   30   30   30   30   1   30   30   30   30   30   30   30   30   30   30   30   30   30   30   30   30   30   30   30   30   30   30   30   
30   30   17   17   17   30   30   30   30   30   30   30   30   30   30   30   30   30   30   30   30   30   30   30   30   30   30   3   30   5   6   6   6   7   30   30   30   30   30   9   6   6   6   7   30   30   30   30   30   30   30   30   30   30   30   30   30   30   30   30   
4   30   20   17   19   29   22   23   23   23   23   24   30   29   30   30   30   30   30   29   30   30   30   30   30   30   30   2   30   30   8   8   12   26   26   26   26   26   26   10   8   8   12   30   30   30   30   30   30   30   30   30   30   30   30   30   30   30   30   30   
3   5   6   6   6   6   7   25   25   25   25   14   15   15   16   30   30   30   5   6   6   6   7   30   30   30   30   30   30   30   8   8   28   28   27   28   28   27   28   28   8   8   12   30   30   30   4   30   30   30   30   30   30   30   30   30   30   30   30   30   
3   30   30   30   30   30   30   30   30   30   30   30   17   17   30   30   30   30   30   8   8   8   30   30   29   30   30   30   30   30   13   8   8   8   8   8   8   8   8   8   8   8   11   30   30   30   2   30   30   30   30   30   30   30   30   30   30   30   30   30   
2   30   30   30   30   30   30   30   30   30   30   30   17   17   30   14   16   30   30   13   8   11   5   6   6   7   30   30   30   30   30   30   30   30   30   30   30   30   30   30   30   30   30   30   30   30   30   30   30   4   30   30   30   30   30   30   30   30   30   30   
30   30   30   30   30   30   30   30   30   30   30   30   17   17   30   30   30   30   30   30   30   30   17   13   11   30   30   30   30   30   30   30   30   30   30   30   30   30   30   30   30   30   30   30   30   30   30   30   30   2   30   30   30   30   30   30   30   30   30   30   
30   30   29   30   30   30   30   30   30   30   30   30   17   17   30   30   30   30   1   30   30   30   17   17   17   30   30   30   30   30   30   30   30   30   30   30   30   30   30   30   30   30   30   30   30   30   30   4   30   30   30   30   30   30   30   30   30   30   30   30   
14   15   16   30   30   30   30   30   30   30   30   9   6   6   7   30   1   30   30   30   30   30   17   17   17   30   30   30   30   30   30   30   30   30   30   30   30   30   30   30   30   30   30   30   30   30   30   2   30   30   30   30   30   30   30   30   30   30   30   30   
20   17   19   30   30   30   30   30   30   1   30   10   8   8   30   30   30   30   29   30   30   29   17   17   17   30   22   23   23   23   23   23   24   30   29   30   30   30   30   30   1   30   30   30   30   30   30   30   30   30   30   30   30   30   30   30   30   30   30   30   
6   6   6   6   6   6   7   30   30   30   30   10   8   8   30   30   30   5   6   6   6   6   6   6   6   6   7   25   25   25   25   25   5   6   6   6   6   7   30   30   30   30   5   6   6   7   30   30   30   30   30   30   30   30   30   30   30   30   30   30   
8   8   8   8   8   11   26   26   26   26   26   13   8   8   26   26   26   26   10   8   8   8   8   8   8   11   26   26   26   26   28   28   30   13   8   8   12   30   26   26   26   30   28   28   28   28   28   28   30   30   30   30   30   30   30   30   30   30   30   30   
8   8   12   28   28   28   27   28   28   27   28   28   10   8   28   27   28   28   10   8   8   8   8   8   8   27   28   28   27   28   28   28   30   30   13   8   11   30   28   27   28   27   28   28   27   28   28   27   28   28   28   30   30   30   30   30   30   30   30   30
#fin